111111111111111111111111111111111111111111
100000000000000000000000000000000000000001
100004000000000000000000000000000000000001
100000000000000000000000000000000000008001
122222220022000022220000000000000000022201
100000000011000011110000000000002200011101
100000000000000000000000000000000000011101
100000000000000000000000000000000000000001
100000000000000000000000022220000000000001
130000000000000000000000011110000000000001
100000000000000222200000000000000000000001
100000000000000111100000000000000000000001
126662000000000000000000000000000000000001
111111000000000000000000000000000000000001
100000000000000000000000000000000000000001
100000000000000000000000000002200000000001
100000000220000000022000000001100000000001
130300000110000000011000000000000000000001
100000000000000000000000000000000026666621
100000000000000000000000000000000011111111
122200000000000000000000000000000093030301
100000000000000030000000000303000090303031
100000000000300007000007000000000093030301
100000000300000022222222222222222222222221
100050000000222211111111111111111111111111
100000000222111111111111111111111111111111
100000022111111111111111111111111111111111
122222211111111111111111111111111111111111
111111111111111111111111111111111111111111