0000000000000000000000000000000000000000
0000000000000000000000000000000000000000
0000000000000000000000000000000000000000
0000000000000000000000000000000000000000
0000000000000000000000000000000000000000
0000000000000000000000000000000000000000
0000000000000000000000000000000000000000
0000000000000000000000000000000000000000
0000000000000000000000000000000000000000
0000000000000000000004000000000000000000
0000000000000000000000000000000000000000
0000000000000000000222200000000000000000
0000000000000000000111100000000000000000
0000000000020000000000000000000000000000
0000000000000000000000000000000000000000
0000000200000000000000000000000000000000
0000000000000000000000000000000000000000
0000000000000000000000000000000000000000
0002200000000000000000000000000000000000
0000000000000000000000000000000000000000
0000000000000000000000000090000000000000
0000000022000000000000000090007000000000
0000000000000000000000000090002222200000
0005000000000003000300300090000000000000
0000000000008000000000000090000000000000
0000000000000000000000000090000000000000
2222222222222222222222222222222222222222
1111111111111111111111111111111111111111