111111111111111111111111111111111111111111
100000000000000000000000000000000000000001
100000000000000000000000000000000000000001
100303000000000000000000000000000000000001
100030000000000000000000000000000000000001
100303000000000000000000000000000000000001
100030000004000000000000000000000000000001
100303000000000000000000000000000000000001
100222000022220000000000000000000000000001
100000000011110000000000000000000000000001
100000000011110000300003000030000000000001
100000000000000000000000000000000000000001
100000000000000000222222222220000000030031
100000000000000000111111111110000000000001
100000000000000000000000000000000000022221
100000000000000000000000000000000000011111
100000000000000000000000000000000000000001
100000000000000000000000000000000000000001
100000000000000000000000000000030000300001
100000000000000000000000030000000000000001
100000000000000000000000000000022222200001
100000000000000000300300000000211111100001
100000000000000000000000000000000000000001
105000000300030000222200000000000000000001
100000000000000000111100000000000000000001
100000000222220000000000000030303030000001
100000000111110000000000000000000000000001
122222222111112222222222222222222222222221
111111111111111111111111111111111111111111