100000000000000000000000000000000000000001
100000000000000000000000000000000000000001
100000000000000000000000000000000000000001
100000000000000000000000000000000000000001
100000000000000000400000000000000000000001
100000000000000000000000000000000000000001
100000000266666622222666666200000000000001
100000000111111111111111111100000000000001
100000000000000000000000000000000000000001
100000000000000000000000000000000000000001
100000000000000000000000000000000000000001
100000000000000000000000000000000000000001
120002000200020002000200020002000200020001
100000000000000000000000000000000000000001
103030303030303030303030303030303030303031
100000000000000000000000000000000000000001
103030303030303030303030303030303030303031
100000000000000000000000000000000000000001
120002000200020002000200020002000200020001
100000000000000000000000000000000000000001
103030303030303030303030303030303030303031
100000000000000000000000000000000000000001
103030303030303030303030303030303030303031
100000000000000000000000000000000000000001
120002000200020002000200020002000205020001
100000000000000000000000000000000000000001
100000000000000000000000000000000000000001
122222222222222222222222222222222222222221
111111111111111111111111111111111111111111