111111111111111111111111111111111111111111
100000000000000000000000000000000000000001
100000000000000000000000000000000000000001
100000000000000000004000000000000000000001
100000000000000000000000000000000000000001
100000030000000000002666662000000000000001
100000000000026662001111111000000000000001
166666620000011111000000000000000000300001
111111110000000000000000000000000000000001
100000000000000000000000000000030000000001
100000000000000000000000000000000000000001
100300000000030000000000000000026666666661
100000000000000000000000000000011111111111
100266666666620000003000003000000000000001
100111111111110000000000000000000000000001
100000000000000000002666662000000000000001
100000000000000000001111111000000000000001
100003000000300000000000000000000000000001
120000000000000000000000000000000000000301
110002666622000000300300000000000000000001
110001111111100000000000000000003000000301
100000000000000000266620000000000000000001
100000000000000000111110000000002666662201
100000000000000000000000000000001111111101
130050000000000000000000000000000000000001
100000000000000000000000000000000000300001
100000000000000000000000000000000030000001
226626666666222666666662222666622226666661
111111111111111111111111111111111111111111