0000000000000000000000000000000000000000
0000000000000000000000000000000000000000
0000000000000000000000000000000000000000
0000000000000000000000000000000000000000
0000000000000000000000000000000000000000
0000000000000000000000000000000000000000
0000000000000000000000000000000000000000
0000000000000000000000000000000000000000
0000000000000000000000000000000000000000
0000000000000000000004000000000000000000
0000000000000000000000000000000000000000
0000000000000000000222200000000000000000
0000000000000000000111100000000000000000
0000000000000000000000000000000000000000
0000000000000020000000000000000000000000
0000000002000000000000000000000000000000
0000000000000000000000000000000000000000
0000200000000000000000000000000000000000
0000000000000000000000000000000000000000
0000000000000000000000000000000000000000
0000000000000000000000000000000000000000
0000000200000000000000000000000000000000
0000000000000000000000000000000000000000
0500000000020000000000300000000000000000
0000000000000000000000000000000000000000
0000000000000000000000000000000000000000
2222222222222222222222222222222222222222
1111111111111111111111111111111111111111