100000000000000000000000000000000000000001
100000000000000000000000000000000000000001
100000000000000000000000000000000000000001
100000000000000000000000000000000000000001
100000000000000000000000000000000000000001
100000000000000000000000000000000000000001
100000000000000000000000000000000000000001
100000000000000000000000000000000000000001
100000000000000000000000000000000000000001
100000000000000000000000000000000000000001
100000000000000000000000000000000000000001
100000000000000000000000000000000000000001
100000000000000000000000000000000000000001
100000007000000700000000000000000000000001
100000002222222222222200000003000000034001
100000001111111111111100000000000000000001
100000000000000000000000000002266666222001
100000000000000000000000000001111111111001
100000000000000000000000300000000000000001
100000000000000070000000000000000000000001
100300300000000222222222200000000000000001
100000000000000111111111100000000000000001
100222200000000000000000000000000000000001
100111100000000000000000000000000000000001
100000000000000000000000000000000000005001
100000000000000000000000000000000000000001
170000000000000007000000070000000000000001
122222266666666222222222222222222222222221
111111111111111111111111111111111111111111